########
#@...#.#
#..#...#
#....###
#.##...#
#....#o#
########
