########
#.#...o#
#.#.#.##
#...#..#
###....#
#@...#.#
########
