########
#....#@#
##.#...#
#....###
#.##...#
#o...#.#
########
